

1111111111111
1001000000001
1000011111001
1C000P000E001
1111111111111
